 # for wall tex NO WE SO EA  ||  s (doors) || 012 for wall pics
# F  floor 
 # sprites 3 - 9
   # 5 is for lights

4 | 3 ./test/bonus/texture/wor.xpm   | 5 ./test/bonus/texture/lamp.xpm | 6 ./test/bonus/texture/table.xpm
2 | 4 ./test/bonus/texture/barrel.xpm | 2 ./test/bonus/texture/WoodenWallWithPoster0.xpm 

  WE  ./test/bonus/texture/lmorpho.xpm
   C    255 , 22 , 255
    NO  ./test/bonus/texture/mossy.xpm
  SO  ./test/bonus/texture/greystone.xpm
 F ./test/bonus/texture/floor.xpm
  EA ./test/bonus/texture/bluestone.xpm

   R    1500   1100 



111111111111111111111111111111111111                 1111111
    110000200020011000000000000000211111111111       11111  11111111
    11000021000002011100000020000010001110001111111111    11 11    1111111111111
     111100200110060000110000010001111111111111        111     1111   1100000001 
     1111111111110011111111111111111111                               1111111111
                1001
        11111111100111111111111111111
        10000600011100060006000010011              111        111    111
1111111111100000000011000001110111101    1111      111          111111
1111111000000111s111110111000000106011111111      11011         111
1100000011110111s1111101110101001000000000011      1111         11
 111111000000000s10201011100000000011111100011     11111111111111
      112000s0E000060000ss000000100011111111011111111
        10000040500003001101010010001111111101111111
        1111111111s1s1111111111111111111111111111111111
        1111111111s1s1111111111111111111111111111111111111
111111111100000012020101111101111000000000100001111111
110111000000111111000011111110101111001100000111
1111111111100111111111111111111111111000001111
         11111                      11011111
         11111          111         1111 
         11111         11            11
            11        11              1
             11111111111            11
      

